435,436,437,438,439,440,441,442,443,444,445,446,447,448,449,450,451,452,453,454,455,456,457,458,459,460,461,462,463,464,465,466
471,472,473,474,475,476,477,478,479,480,481,482,483,484,485,486,487,488,489,490,491,492,493,494,495,496,497,498,499,500,501,502
507,508,509,510,511,512,513,514,515,516,517,518,519,520,521,522,523,524,525,526,527,528,529,530,531,532,533,534,535,536,537,538
543,544,545,546,547,548,549,550,551,552,553,554,555,556,557,558,559,560,561,562,563,564,565,566,567,568,569,570,571,572,573,574
579,580,581,582,583,584,585,586,587,588,589,590,591,592,593,594,595,596,597,598,599,600,601,602,603,604,605,606,607,608,609,610
615,616,617,618,619,620,621,622,623,624,625,626,627,628,629,630,631,632,633,634,635,636,637,638,639,640,641,642,643,644,645,646
651,652,653,654,655,656,657,658,659,660,661,662,663,664,665,666,667,668,669,670,671,672,673,674,675,676,677,678,679,680,681,682
687,688,689,690,691,692,693,694,695,696,697,698,699,700,701,702,703,704,705,706,707,708,709,710,711,712,713,714,715,716,717,718
190,191,192,193,194,190,191,192,193,194,190,191,192,193,194,190,191,192,193,194,190,191,192,193,194,190,191,192,193,194,190,191
227,227,228,229,230,231,227,228,229,230,231,227,228,229,230,231,227,228,229,230,231,227,228,229,230,231,227,228,229,227,228,229
264,264,265,266,267,268,264,265,266,267,268,264,265,266,267,268,264,265,266,267,268,264,265,266,267,268,264,265,266,264,265,266
301,301,302,303,304,305,301,302,303,304,305,301,302,303,304,305,301,302,303,304,305,301,302,303,304,305,301,302,303,301,302,303
213,214,215,216,217,213,214,215,216,217,213,214,215,216,217,213,214,215,216,217,213,214,215,216,217,213,214,215,216,217,213,214
250,251,252,253,254,250,251,252,253,254,250,251,252,253,254,250,251,252,253,254,250,251,252,253,254,250,251,252,253,254,250,251
287,288,289,290,291,287,288,289,290,291,287,288,289,290,291,287,288,289,290,291,287,288,289,290,291,287,288,289,290,291,287,288
324,325,326,327,328,324,325,326,327,328,324,325,326,327,328,324,325,326,327,328,324,325,326,327,328,324,325,326,327,328,324,325
361,362,363,364,365,361,362,363,364,365,361,362,363,364,365,361,362,363,364,365,361,362,363,364,365,361,362,363,364,365,361,362
